-___-_-_-___-___-
=...=.=.=...=...=
=...=.=.=...=...=
=_-_=.=.=_-_=___=
..=.=.=.=.=.=...=
..=.=_=_=.=.=...=
..=.=.=.=.=.=_-_=
-_=_=_=.=.=.=.=..
=.=.=.=.=.=.=.=..
=.=.=___=___=.=..
=.=.=...=...=.=..
=.=.=...=...=_=_-
=.=.=___=___=.=.=
=_=_=...=...=.=.=
=...=...=...=.=.=
=___=___=___=_=_=

