_____________
..=.......=..
..=.......=..
._=__...._=__
............=
............=
____________=

